13 207
000000000000000000000000000000000000000000000000000000000000000000000000000000000000000000000000000000000000000000000000000000000000000000000000000000000000000000000000000000000000000000000000000000000000000
00000000000000000000c0000000000000000n000000000000000000000000000000c0000000000000000n0000000000000000000000000000c00000000000000n00000000000000000000000000000000c00000000000000000n00000000000000000000000000
00000000c000000000000000000C00000000000000000000000000000c000000000000000000C000000000000000000000000000c00000000000000000C00000000000000000000000000000c000000000000000000C0000000000000000000000000000c000000
0000000000000000000000?000000000000000000000000000000000000000000000000000000000########000###?0000000000000?0000000000###000#??#0000000000000000000000000000000000000000000000000000000000!!000000000000000000
000000000000000000000000000000000000000000000000000000000000000000000000000000000000000000000000000000000000000000000000000000000000000000000000000000000000000000000000000000000000000000!!!000000000000000000
00000000000000000000000000000000000000000000000000000000000000000000000000000000000000000000000000000000000000000000000000000000000000000000000000000000000000000000000000000000000000000!!!!000000000000000000
0000000000000000000000000000000000000000000000000000000000000000000000000000000000000000000000000000000000000000000000000000000000000000000000000000000000000000000000000000000000000000!!!!!000000000000000000
0000000000000000?000#?#?#0000000000000000000000000000000000000000000000000000#?#00000000000000#0000##0000?00?00?00000#00000000##00000000!00!0000000000!!00!000000000000####000000000000!!!!!!000000000000000000
000000000000000000000000000000000000000000000000000000000000000000000000000000000000000000000000000000000000000000000000000000000000000!!00!!00000000!!!00!!00000000000000000000000000!!!!!!!000000000000000000
00000000000000000000000000000000000000P0000000P0000000000P0000000000000000000000000000000000000000000000000000000000000000000000000000!!!00!!!000000!!!!00!!!000000000000000000000000!!!!!!!!000000000000000000
H00000000000B000h0000000b000P000000000p000m000p0H00000000p0B000h0000000b00000000000000000m000000H000000000B000h00000000b0000000000000!!!!b0!!!!H000!!!!!00!!!!0h00P0000b0000000000P0!!!!!!!!!00H00000!000000000
*********************************************************************00***************000***************************************************************00*****************************************************
*********************************************************************00***************000***************************************************************00*****************************************************
